NO texture/red.png
SO texture/sky.png
EA texture/moon.png
WE texture/clock.png

C 255,200,160
F 122,122,122

1111111111111111111
     101
    10001
   1000001
  111111111
 10000000001111111
100100E000000000001
 10000000001111111
  100000111
   100001
    10001
     101
1111111111111111111
